Posting Date ,Value Date ,BackOffice Reference ,Description ,Related Reference ,Cheque Number ,Withdrawal ,Deposit ,Balance 
30/11/20 20 ,30/11/20 20 ,TT203354VN 0X ,TT203354VN0X - Home Cheque Deposit OSAMA MOHAMED 28710122103113 - CHEQUE NO 513269417 ,,513269417 ,,"13,167.00 ","943,735.86 "
30/11/20 20 ,30/11/20 20 ,TT20335KB5 XM ,TT20335KB5XM Home Cheque Deposit OSAMA MOHAMED 28710122103113 - CHEQUE NO 505709617 ,,505709617 ,,"216,210.00 ","1,159,945.86 "
30/11/20 20 ,30/11/20 20 ,TT20335TYB 2G ,TT20335TYB2G - Home Cheque Deposit MOHAMED MAHMOUD 28704011202953 - CHEQUE NO 514584242 ,,514584242 ,,"18,468.00 ","1,178,413.86 "
30/11/20 20 ,30/11/20 20 ,TT20335V65 PV ,TT20335V65PV - Home Cheque Deposit MOHAMED MAHMOUD 28704011202953 - CHEQUE NO 503028912 ,,503028912 ,,"25,675.00 ","1,204,088.86 "
30/11/20 20 ,30/11/20 20 ,FT203350Q0 SM ,FT203350Q0SM - Inward ACH ACH(09202011300055 -40) RTIN(OTHERS (MUST BE VERY SPECIFIC)VILLA 3570 C ELIA COMPOUNDNEW ADMINISTRATIVE CAP ITAL) FROM(EG12002500370 00000370399 COMMISSION AMOUNT ,,,,"315,000.00 ","1,519,088.86 "
30/11/20 20 ,28/11/20 20 ,FT20335PST 8P ,FT20335PST8P - 1301024408135 Inward - 1301024408135 Funds I.F.O. 100011856807 ARAB CO. FOR PROJECT SWIFT FROM AL ANSARI EXCHANGE funds B/O : SAYED SHAABAN MOSTAFA A HMED NO 51028 DUBAI ,,,,"42,420.00 ","1,561,508.86 "
